111111111111111111
1E0000000000000001
101001010010000011
101001001010101001
1P0000000000000001
111111111111111111